111111111111111111111111111111111111111111111111111111111111111111111111111111111111111111111111111111111
100000C11111000000000111111111111111111111111111110000000000C0C0C0C0C000000000000000000000000E0000000C001
100000E11111000000000111111111111111111111111111110000000000C0C0C0C0C000000000000000000000000E0000000C001
100000P0000E000000000111111111111111111111111111110000000000C0C0C0C0C000000000000000000000000E0000000C001
111111111111000000000111111111111111111111111111110000000000C0C0C0C0C000000000000000000000000E0000000C001
11111111111100000C000111111111111111111111111111110000000000C0C0C0C0C000000000000000000000000E0000000C001
111111111111000000000111111111111111111111111111110000000000C0C0C0C0C000000000000000000000000E0000000C001
11111111111110000E111111111111111111111111111111110000000000C0C0C0C0C000000000000000000000000E0000000C001
111111111111100000111111111111111111111111111111110000000000C0C0C0C0C000000000000000000000000E0000000C001
111111111111100000000000000000000000000000000000000000000000C0C0C0C0C000000000000000000000000E0000000C001
111111111111100000111111111111111111111111111111110000000000C0C0C0C0C000000000000000000000000E0000000C001
11111111111110000C111111111111111111111111111111110000000000C0C0C0C0C000000000000000000000000E0000000C001
1111111111111E0000111111111111111111111111111111110000000000C0C0C0C0C000000000000000000000000E0000000C001
111111111111111110111111111111111111111111111111110000000000C0C0C0C0C000000000000000000000000E0000000C001
111111111111111110111111111111111111111111111111110000000000C0C0C0C0C000000000000000000000000E0000000C001
100000C11111000000000111111111111111111111111111110000000000C0C0C0C0C000000000000000000000000E0000000C001
100000E11111000000000111111111111111111111111111110000000000C0C0C0C0C000000000000000000000000E0000000C001
100000000000E00000000011111111111111111111111111110000000000C0C0C0C0C000000000000000000000000E0000000C001
111111111111000000000111111111111111111111111111110000000000C0C0C0C0C000000000000000000000000E0000000C001
11111111111100000C000111111111111111111111111111110000000000C0C0C0C0C000000000000000000000000E0000000C001
111111111111000000000111111111111111111111111111110000000000C0C0C0C0C000000000000000000000000E0000000C001
11111111111110000E111111111111111111111111111111110000000000C0C0C0C0C000000000000000000000000E0000000C001
111111111111100000111111111111111111111111111111110000000000C0C0C0C0C000000000000000000000000E0000000C001
111111111111100000111111111111111111111111111111110000000000C0C0C0C0C000000000000000000000000E0000000C001
111111111111100000111111111111111111111111111111110000000000C0C0C0C0C000000000000000000000000E0000000C001
11111111111110000C111111111111111111111111111111110000000000C0C0C0C0C000000000000000000000000E0000000C001
1111111111111E0000111111111111111111111111111111110000000000C0C0C0C0C000000000000000000000000E0000000C001
100000E11111000000000111111111111111111111111111110000000000C0C0C0C0C000000000000000000000000E0000000C001
100000E11111000000000111111111111111111111111111110000000000C0C0C0C0C000000000000000000000000E0000000C001
111111111111111111111111111111111111111111111111111111111111111111111111111111111111111111111111111111111