11111111
110110P1
11E01111
11111111