11111
100C1
1E101
101P1
1C101
11111